i	Voyelle	y|i
e	Voyelle	er|ez|é|et|ais|ait|est
ɛ	Voyelle	ei|ê|è|ay|e
a	Voyelle	a|à
ɑ	Voyelle	a|à
ɔ	Voyelle	on|om
o	Voyelle	o|eau|au|ô
u	Voyelle	ou
y	Voyelle	u|eu
ø	Voyelle	eu|eau|œu|e
œ	Voyelle	eu|uei|œu
ə	Voyelle	eu|e
ẽ	Voyelle	in|ain|ein|aim|im|ym|yn|en
ã	Voyelle	an|am|en|em|aon
ɔ̃	Voyelle	on|om
œ̃	Voyelle	un|um
p	Consonne	p|pp
t	Consonne	t|tt|th
k	Consonne	k|q|cc|ch|qu|c
b	Consonne	b|bb
d	Consonne	d|dd
g	Consonne	g|gu|gg
f	Consonne	f|ph|ff
s	Consonne	s|t|ss|ç|c|x|sc
ʃ	Consonne	ch|sch|sc
v	Consonne	v|w
z	Consonne	z|x
ʒ	Consonne	g|j
l	Consonne	l|ll
ʀ	Consonne	r|rr
m	Consonne	m|mm
n	Consonne	n|nn
ɲ	Consonne	gn
j	Semi-voyelle	ill|i
w	Semi-voyelle	ou|w
ɥ	Semi-voyelle	ui
